San Diego	California
Pellston	Michigan
Buffalo	New York
Charlotte Amalie	St. Thomas
Flagstaff	Arizona
Evansville	Indiana
Hilo	Hawaii
Twin Falls	Idaho
Newark	New Jersey
State College	Pennsylvania
Johnstown	Pennsylvania
Charleston	South Carolina
Montgomery	Alabama
Redding	California
Lynchburg	Virginia
South Bend	Indiana
Sarasota	Florida
Sioux Falls	South Dakota
Paducah	Kentucky
Kahului	Hawaii
Atlantic City	New Jersey
Bemidji	Minnesota
Toledo	Ohio
Abilene	Texas
Sacramento	California
Amarillo	Texas
Moline	Illinois
Hilton Head	South Carolina
Manhattan	New York
Minneapolis	Minnesota
Fort Myers	Florida
Roswell	New Mexico
Harlingen	Texas
Seattle	Washington
Manchester	England
Gulfport	Mississippi
Gainesville	Florida
Pago Pago	Eastern District
Wrangell	Alaska
Augusta	Georgia
Waterloo	Wallonia
Yuma	Arizona
Saipan	Saipan
Christiansted	St. Croix
North Bend	Oregon
Richmond	Virginia
Albuquerque	New Mexico
Nashville	Tennessee
Aberdeen	Scotland
Harrisburg	Pennsylvania
Fort Wayne	Indiana
Green Bay	Wisconsin
Wenatchee	Washington
Santa Fe	New Mexico
St. Petersburg	Saint Petersburg
Belleville	Illinois
Greensboro	North Carolina
Lake Charles	Louisiana
Traverse City	Michigan
Erie	Pennsylvania
Niagara Falls	New York
Pocatello	Idaho
Idaho Falls	Idaho
Alpena	Michigan
Wilmington	North Carolina
Ontario	Ontario
Iron Mountain	Michigan
Lubbock	Texas
Helena	Montana
Kalamazoo	Michigan
Cleveland	Ohio
Grand Island	Nebraska
New Bern	North Carolina
Melbourne	Victoria
Bristol	Tennessee
Orlando	Florida
Bismarck	North Dakota
Fresno	California
Billings	Montana
Jackson	Mississippi
Daytona Beach	Florida
College Station	Texas
Jacksonville	Florida
Salt Lake City	Utah
Corpus Christi	Texas
Florence	Tuscany
Moab	Utah
Grand Forks	North Dakota
Las Vegas	Nevada
Fairbanks	Alaska
Petersburg	Virginia
Wichita	Kansas
Rhinelander	Wisconsin
Kansas City	Missouri
Dothan	Alabama
Alamosa	Colorado
Adak Island	Alaska
Islip	New York
Wichita Falls	Texas
Presque Isle	Maine
San Luis Obispo	California
Dayton	Ohio
Fort Smith	Arkansas
Martha's Vineyard	Massachusetts
Portland	Oregon
Waco	Texas
New York	New York
Columbus	Ohio
Tampa	Florida
Little Rock	Arkansas
Kona	Hawaii
Clarksburg	West Virginia
San Angelo	Texas
Saginaw	Michigan
Houston	Texas
Duluth	Minnesota
Valparaiso	Indiana
Phoenix	Arizona
Oakland	California
Watertown	New York
Ogden	Utah
Cedar Rapids	Iowa
Cape Girardeau	Missouri
Sun Valley	Idaho
Sault Ste. Marie	Ontario
Trenton	New Jersey
Missoula	Montana
Pasco	Washington
Brainerd	Minnesota
Newburgh	New York
Gustavus	Minnesota
Branson	Missouri
Providence	Rhode Island
Minot	North Dakota
Huntsville	Alabama
San Antonio	Texas
Marquette	Wisconsin
Owensboro	Kentucky
Del Rio	Texas
Portsmouth	England
Bloomington	Illinois
Lexington	Kentucky
Santa Barbara	California
Baltimore	Maryland
Panama City	Florida
Kodiak	Alaska
Yakima	Washington
Vernal	Utah
Salisbury	Maryland
Mission	Texas
Newport News	Virginia
Charlottesville	Virginia
Grand Junction	Colorado
Baton Rouge	Louisiana
Beaumont	Texas
Staunton	Virginia
Kalispell	Montana
Key West	Florida
Worcester	England
West Palm Beach	Florida
Boise	Idaho
Grand Rapids	Michigan
Salina	Kansas
Fort Leonard Wood	Missouri
Walla Walla	Washington
Everett	Washington
Dillingham	Alaska
Lansing	Michigan
Madison	Wisconsin
Victoria	Victoria
Sioux City	Iowa
Hattiesburg	Mississippi
Stockton	California
Anchorage	Alaska
Charlotte	North Carolina
Jamestown	Virginia
Laramie	Wyoming
Decatur	Georgia
Durango	Colorado
Longview	Texas
Syracuse	New York
St. Cloud	Minnesota
Santa Rosa	California
Bakersfield	California
North Platte	Nebraska
La Crosse	Wisconsin
Plattsburgh	New York
Concord	New Hampshire
Atlanta	Georgia
Provo	Utah
Ogdensburg	New York
Ithaca	New York
Colorado Springs	Colorado
Washington	District of Columbia
Williston	North Dakota
Tulsa	Oklahoma
Midland	Texas
Champaign	Illinois
Devils Lake	Wisconsin
Greer	South Carolina
Muskegon	Michigan
Hibbing	Minnesota
Santa Ana	California
Ponce	Ponce
Prescott	Arizona
Indianapolis	Indiana
International Falls	Minnesota
Rapid City	South Dakota
Ketchikan	Alaska
St. Louis	Missouri
Santa Maria	California
Elmira	New York
Alexandria	Alexandria Governorate
San Jose	California
Tucson	Arizona
San Juan	San Juan
Dubuque	Iowa
Burbank	California
Gunnison	Colorado
Cedar City	Utah
Hyannis	Massachusetts
Raleigh	North Carolina
Norfolk	Virginia
New Orleans	Louisiana
Medford	Oregon
White Plains	New York
Oklahoma City	Oklahoma
Chicago	Illinois
El Paso	Texas
Rockford	Illinois
Aguadilla	Aguadilla
Omaha	Nebraska
Scottsbluff	Nebraska
Yakutat	Alaska
Arcata	California
Spokane	Washington
Brownsville	Texas
Bend	Oregon
Hagerstown	Maryland
Peoria	Illinois
Appleton	Wisconsin
Roanoke	Virginia
Eugene	Oregon
Rock Springs	Wyoming
Dodge City	Kansas
Austin	Texas
Miami	Florida
Dallas	Texas
Mosinee	Wisconsin
Killeen	Texas
Lihue	Hawaii
Pittsburgh	Pennsylvania
Tallahassee	Florida
Butte	California
Lawton	Oklahoma
Honolulu	Hawaii
Greenville	South Carolina
Juneau	Alaska
Myrtle Beach	South Carolina
Boston	Massachusetts
Latrobe	Pennsylvania
Knoxville	Tennessee
Denver	Colorado
Bangor	Maine
Albany	New York
Punta Gorda	Florida
Fort Lauderdale	Florida
Philadelphia	Pennsylvania
Binghamton	New York
Great Falls	Montana
Shreveport	Louisiana
Asheville	North Carolina
Cheyenne	Wyoming
Milwaukee	Wisconsin
Nome	Alaska
Laredo	Texas
Des Moines	Iowa
Fayetteville	North Carolina
Lewisburg	Pennsylvania
Fort Dodge	Iowa
Cody	Wyoming
Chattanooga	Tennessee
Deadhorse	Alaska
Kotzebue	Alaska
Sitka	Alaska
Bozeman	Montana
Palm Springs	California
Memphis	Tennessee
Nantucket	Massachusetts
Texarkana	Texas
Lewiston	Idaho
Valdosta	Georgia
Birmingham	England
Scranton	Pennsylvania
Pensacola	Florida
Hancock	Michigan
Los Angeles	California
Mason City	Iowa
Savannah	Georgia
West Yellowstone	Montana
Long Beach	California
Reno	Nevada
Akron	Ohio
Louisville	Kentucky
Hartford	Connecticut
Cincinnati	Ohio
Rochester	New York
San Francisco	California
Detroit	Michigan
Monterey	California
Escanaba	Michigan
Eau Claire	Wisconsin